230 14
0 0 0 0 0 0 0 0 0 0 0 44 23 23 
0 0 0 0 0 0 0 0 0 0 44 45 23 23 
0 0 0 0 0 0 0 0 0 47 45 48 23 23 
0 0 0 0 0 0 0 0 0 0 46 45 23 23 
0 0 0 0 0 0 0 0 0 0 0 46 23 23 
0 0 0 0 0 0 0 0 0 0 0 0 23 23 
0 0 0 0 0 0 0 0 0 0 0 0 23 23 
0 0 0 0 0 0 0 0 0 0 0 0 23 23 
0 0 0 0 0 0 0 0 0 0 0 0 23 23 
0 0 34 37 0 0 0 0 0 0 0 0 23 23 
0 0 36 39 0 0 0 0 0 0 0 0 23 23 
0 0 0 0 0 0 0 0 0 0 0 0 23 23 
0 0 0 0 0 0 0 0 0 0 0 33 23 23 
0 0 0 0 0 0 0 0 0 0 0 32 23 23 
0 0 0 0 0 0 0 0 0 0 0 32 23 23 
0 0 0 0 0 0 0 0 0 0 0 31 23 23 
0 0 0 0 0 0 0 0 0 0 0 0 23 23 
0 0 0 0 0 0 0 0 0 0 0 44 23 23 
0 0 0 0 0 0 0 0 0 0 47 45 23 23 
0 0 0 0 0 0 0 0 0 0 0 46 23 23 
0 34 37 0 0 0 0 0 0 0 0 0 23 23 
0 36 39 0 0 0 0 0 29 0 0 0 23 23 
0 0 0 0 0 0 0 0 18 0 0 0 23 23 
0 0 0 0 18 0 0 0 29 0 0 0 23 23 
0 0 0 0 0 0 0 0 18 0 0 0 23 23 
0 0 0 0 0 0 0 0 29 0 16 33 23 23 
0 0 0 0 0 0 0 0 0 0 0 31 23 23 
0 0 0 0 0 0 0 0 0 0 0 0 23 23 
0 0 0 0 0 0 0 0 0 0 0 0 23 23 
0 0 34 37 0 0 0 0 0 0 24 27 23 23 
0 0 35 38 0 0 0 0 0 0 25 26 23 23 
0 0 35 38 0 0 0 0 0 0 0 0 23 23 
0 0 36 39 0 0 0 0 0 0 0 0 23 23 
0 0 0 0 0 0 0 0 0 0 0 0 23 23 
0 0 0 0 0 0 0 0 0 0 0 0 23 23 
0 0 0 0 0 0 0 0 0 0 0 0 23 23 
0 0 0 0 0 0 0 0 0 0 0 0 23 23 
0 0 0 0 0 0 0 0 0 0 0 0 23 23 
0 34 37 0 0 0 0 0 0 0 0 0 23 23 
0 35 38 0 0 0 0 0 0 24 27 27 23 23 
0 36 39 0 0 0 0 0 0 25 26 26 23 23 
0 0 0 0 0 0 0 0 0 0 0 0 23 23 
0 0 0 0 0 0 0 0 0 0 0 33 23 23 
0 0 0 0 0 0 0 0 0 0 0 32 23 23 
0 0 0 0 0 0 0 0 0 0 0 32 23 23 
0 0 0 0 0 0 0 0 0 0 0 31 23 23 
0 0 0 0 0 0 0 0 0 0 0 0 23 23 
0 0 0 0 0 0 0 0 24 27 27 27 23 23 
0 0 0 0 0 0 0 0 25 26 26 26 23 23 
0 0 0 0 0 0 0 0 0 0 0 44 23 23 
0 0 0 0 0 0 0 0 0 0 44 45 23 23 
0 0 0 0 0 0 0 0 0 47 45 48 23 23 
0 0 0 0 0 0 0 0 0 0 46 45 23 23 
0 0 0 0 0 0 0 0 0 0 0 46 23 23 
0 0 0 0 0 0 0 0 0 0 0 16 23 23 
0 0 0 0 0 0 0 0 0 0 0 0 23 23 
0 0 0 0 0 0 0 0 0 0 0 16 23 23 
0 0 34 37 0 0 0 0 0 0 0 0 23 23 
0 0 36 39 0 0 0 0 24 27 27 27 23 23 
0 0 0 0 0 0 0 0 25 26 26 26 23 23 
0 0 0 0 0 0 0 0 0 0 0 0 23 23 
0 0 0 0 0 0 0 0 0 0 0 33 23 23 
0 0 0 0 0 0 0 0 0 0 0 32 23 23 
0 0 0 0 0 0 0 0 0 0 0 32 23 23 
0 0 0 0 0 0 0 0 0 0 0 31 23 23 
0 0 0 0 0 0 0 18 0 0 0 44 23 23 
0 0 0 0 0 0 0 0 0 0 47 45 23 23 
0 0 0 0 0 0 0 0 0 0 0 46 23 23 
0 0 0 0 0 0 0 0 0 0 0 0 23 23 
0 34 37 0 0 0 0 0 0 0 0 0 23 23 
0 36 39 0 0 0 0 0 0 0 0 0 0 0 
0 0 0 0 0 0 0 0 0 0 0 0 0 0 
0 0 0 0 0 0 0 0 0 0 0 0 23 23 
0 0 0 0 0 0 0 0 0 0 0 33 23 23 
0 0 0 0 0 0 0 0 0 0 0 31 23 23 
0 0 0 0 0 0 0 0 0 0 0 0 23 23 
0 0 0 0 0 0 0 0 0 0 0 0 23 23 
0 0 34 37 0 0 0 0 0 0 0 0 23 23 
0 0 35 38 0 0 0 0 29 0 0 0 23 23 
0 0 35 38 0 0 0 0 18 0 0 0 23 23 
0 0 36 39 0 0 0 0 29 0 0 0 23 23 
0 0 0 0 29 0 0 0 0 0 0 0 23 23 
0 0 0 0 29 0 0 0 0 0 0 0 23 23 
0 0 0 16 29 0 0 0 0 0 0 0 23 23 
0 0 0 0 29 0 0 0 0 0 0 0 23 23 
0 0 0 0 29 0 0 0 0 0 0 0 23 23 
0 34 37 16 29 0 0 0 0 0 0 0 23 23 
0 35 38 0 29 0 0 0 0 0 0 0 0 0 
0 36 39 0 29 0 0 0 0 0 0 0 0 0 
0 0 0 0 0 0 0 0 0 0 0 0 0 0 
0 0 0 0 0 0 0 0 0 0 0 0 23 23 
0 0 0 0 0 0 0 0 0 0 0 33 23 23 
0 0 0 0 0 0 0 0 0 0 0 32 23 23 
0 0 0 0 29 0 0 0 0 0 0 31 23 23 
0 0 0 0 29 0 0 0 0 0 0 0 23 23 
0 0 0 0 18 0 0 0 29 0 0 0 23 23 
0 0 0 0 0 0 0 0 0 0 0 16 23 23 
0 0 0 0 0 0 0 0 0 0 0 44 23 23 
0 0 0 0 0 0 0 0 0 16 44 45 23 23 
0 0 0 0 0 0 0 0 0 47 45 48 23 23 
0 0 0 0 0 0 0 0 0 0 46 45 23 23 
0 0 0 0 0 0 0 0 29 0 0 46 23 23 
0 0 0 0 0 0 0 0 18 0 0 0 23 23 
0 0 0 0 0 0 0 0 0 0 0 0 23 23 
0 0 0 0 0 0 0 0 0 0 0 0 23 23 
0 0 34 37 0 0 0 0 0 0 0 0 23 23 
0 0 35 38 0 0 0 0 0 0 0 0 23 23 
0 0 36 39 0 0 0 0 18 0 0 53 23 23 
0 0 0 0 0 0 0 0 0 0 0 0 23 23 
0 0 0 0 0 0 0 0 0 0 0 33 23 23 
0 0 0 0 18 0 0 0 18 0 0 32 23 23 
0 0 0 0 0 0 0 0 0 0 0 32 23 23 
0 0 0 0 0 0 0 0 0 0 16 31 23 23 
0 0 0 0 0 0 0 0 18 0 0 0 23 23 
0 0 0 0 0 0 0 0 0 0 16 44 23 23 
0 0 0 0 0 0 0 0 0 0 47 45 23 23 
0 0 0 0 0 0 0 0 0 0 0 46 23 23 
0 0 0 0 0 0 0 0 0 0 0 0 23 23 
0 34 37 0 0 0 0 0 0 0 0 0 23 23 
0 35 38 0 0 0 0 0 0 0 0 0 23 23 
0 36 39 0 0 0 0 0 0 0 0 0 23 23 
0 0 0 0 0 0 0 0 29 0 0 0 23 23 
0 0 0 0 0 0 0 0 0 0 0 33 23 23 
0 0 0 0 0 0 0 0 0 0 0 31 23 23 
0 0 0 0 29 0 0 0 0 0 0 16 23 23 
0 0 0 0 29 0 0 0 0 0 0 0 23 23 
0 0 0 0 29 0 0 0 0 0 0 16 23 23 
0 0 0 0 0 0 0 0 0 0 0 0 23 23 
0 0 34 37 0 0 0 0 0 0 0 0 23 23 
0 0 35 38 0 0 0 0 0 0 0 0 23 23 
0 0 36 39 0 0 0 0 0 0 0 0 23 23 
0 0 0 0 29 0 0 0 0 0 0 0 23 23 
0 0 0 0 18 0 0 0 29 0 0 0 23 23 
0 0 0 0 18 0 0 0 29 0 0 0 23 23 
0 0 0 0 29 0 0 0 0 0 0 0 23 23 
0 34 37 0 0 0 0 0 0 0 0 16 23 23 
0 35 38 0 0 0 0 0 0 0 0 16 23 23 
0 36 39 0 0 0 0 0 0 0 0 30 23 23 
0 0 0 0 0 0 0 0 0 0 30 30 23 23 
0 0 0 0 0 0 0 0 0 30 30 30 23 23 
0 0 0 0 0 0 0 0 30 30 30 30 23 23 
0 0 0 0 0 0 0 0 0 0 0 33 23 23 
0 0 0 0 0 0 0 0 0 0 0 31 23 23 
0 0 0 0 0 0 0 0 30 30 30 30 23 23 
0 0 0 0 0 0 0 0 0 30 30 30 23 23 
0 0 0 0 0 0 0 0 0 0 30 30 23 23 
0 0 0 0 0 0 0 0 0 0 0 30 23 23 
0 0 0 0 0 0 0 0 0 0 0 44 23 23 
0 0 0 0 0 0 0 0 0 0 44 45 23 23 
0 0 0 0 0 0 0 0 0 47 45 48 23 23 
0 0 0 0 0 0 0 0 0 0 46 45 23 23 
0 0 0 0 0 0 0 0 0 0 0 30 23 23 
0 0 0 0 0 0 0 0 0 0 30 30 23 23 
0 0 0 0 0 0 0 0 0 30 30 30 23 23 
0 0 0 0 0 0 0 0 30 30 30 30 23 23 
0 0 34 37 0 0 0 0 30 30 30 30 23 23 
0 0 36 39 0 0 0 0 0 0 0 0 0 0 
0 0 0 0 0 0 0 0 0 0 0 0 0 0 
0 0 0 0 0 0 0 0 30 30 30 30 23 23 
0 0 0 0 0 0 0 0 0 30 30 30 23 23 
0 0 0 0 0 0 0 0 0 0 30 30 23 23 
0 0 0 0 0 0 0 0 0 0 0 30 23 23 
0 0 0 0 0 0 0 0 0 0 0 0 23 23 
0 0 0 0 0 0 0 0 0 0 0 44 23 23 
0 0 0 0 0 0 0 0 0 0 47 45 23 23 
0 0 0 0 0 0 0 0 0 0 0 46 23 23 
0 0 0 0 0 0 0 0 0 0 24 27 23 23 
0 34 37 0 0 0 0 0 0 0 25 26 23 23 
0 36 39 0 0 0 0 0 0 0 0 0 23 23 
0 0 0 0 0 0 0 0 0 0 0 0 23 23 
0 0 0 0 0 0 0 0 0 0 0 0 23 23 
0 0 0 0 0 0 0 0 29 0 0 33 23 23 
0 0 0 0 0 0 0 0 29 0 0 31 23 23 
0 0 0 0 0 0 0 0 18 0 0 0 23 23 
0 0 0 0 0 0 0 0 29 0 0 0 23 23 
0 0 0 34 37 0 0 0 0 0 0 0 23 23 
0 0 0 35 38 0 0 0 0 0 0 16 23 23 
0 0 0 35 38 0 0 0 0 0 0 0 23 23 
0 0 0 35 38 0 0 0 0 0 0 16 23 23 
0 0 0 36 39 0 0 0 0 0 0 0 23 23 
0 0 0 0 0 0 0 0 0 0 0 0 23 23 
0 0 0 0 0 0 0 0 0 0 0 0 23 23 
0 0 0 0 0 0 0 0 0 0 24 27 23 23 
0 0 0 0 0 0 0 0 0 0 25 26 23 23 
0 34 37 0 0 0 0 0 0 0 0 30 23 23 
0 35 38 0 0 0 0 0 0 0 30 30 23 23 
0 36 39 0 0 0 0 0 0 30 30 30 23 23 
0 0 0 0 0 0 0 0 30 30 30 30 23 23 
0 0 0 0 0 0 0 30 30 30 30 30 23 23 
0 0 0 0 0 0 30 30 30 30 30 30 23 23 
0 0 0 0 0 30 30 30 30 30 30 30 23 23 
0 0 0 0 30 30 30 30 30 30 30 30 23 23 
0 0 0 0 30 30 30 30 30 30 30 30 23 23 
0 0 0 0 0 0 0 0 0 0 0 0 23 23 
0 0 0 0 0 0 0 0 0 0 0 0 23 23 
0 0 0 0 0 0 0 0 0 0 0 44 23 23 
0 0 0 0 0 0 0 0 0 0 44 45 23 23 
0 0 0 0 0 0 0 0 0 47 45 48 23 23 
0 0 0 0 0 0 0 0 0 0 46 45 23 23 
0 0 0 0 0 0 0 0 0 0 0 46 23 23 
0 0 0 59 0 0 0 0 0 0 0 0 23 23 
0 0 57 58 60 60 60 60 60 60 60 30 23 23 
0 0 0 0 0 0 0 0 0 0 0 0 23 23 
0 0 0 0 0 0 0 0 0 0 0 0 23 23 
0 0 34 37 0 0 0 0 0 0 0 0 23 23 
0 0 36 39 0 0 0 0 0 61 63 63 23 23 
0 0 0 0 0 0 0 61 64 68 63 63 23 23 
0 0 0 0 0 0 62 61 63 68 65 67 23 23 
0 0 0 0 0 0 0 61 66 68 63 63 23 23 
0 0 0 0 0 0 0 0 0 61 63 63 23 23 
0 0 0 0 0 0 0 0 0 0 0 31 23 23 
0 0 0 0 0 0 0 0 0 0 0 0 23 23 
0 0 0 0 0 0 0 0 0 0 0 0 23 23 
0 0 0 0 0 0 0 0 0 0 0 0 23 23 
0 0 0 0 0 0 0 0 0 0 0 0 23 23 
0 0 0 0 0 0 0 0 0 0 0 0 23 23 
0 0 0 0 0 0 0 0 0 0 0 0 23 23 
0 0 0 0 0 0 0 0 0 0 0 0 23 23 
0 0 0 0 0 0 0 0 0 0 24 27 23 23 
0 0 0 0 0 0 0 0 0 0 25 26 23 23 
0 0 0 0 0 0 0 0 0 0 0 0 23 23 
0 0 0 0 0 0 0 0 0 0 0 0 23 23 
0 0 0 0 0 0 0 0 0 0 0 0 23 23 
0 0 0 0 0 0 0 0 0 0 0 0 23 23 
0 0 0 0 0 0 0 0 0 0 0 0 23 23 
0 0 0 0 0 0 0 0 0 0 0 0 23 23 
0 0 0 0 0 0 0 0 0 0 0 0 23 23 
0 0 0 0 0 0 0 0 0 0 0 0 23 23 
0 0 0 0 0 0 0 0 0 0 0 0 23 23 
23 23 23 23 23 23 23 23 23 23 23 23 23 23 

